1111111111111111111111111111
10000000000000000000000000E1
1000000000000000000000000001
1000000000C00000000000C00001
1000000000111111000000C00001
100000C000000001000000000001
1000000000000001000000C00001
10000000P0000001000000000001
1000000000C00001000000000001
1111111111111111111111111111